8 8
S.E#....
##...##.
.####.#.
...#....
.#...###
.#######
.#...###
...####.